w w w w w w w w w w w w w w w w w w w w w w w w w w w w w w w w w w w w w w w w w w w w w w w w w w w w w w w w w w w w w w w w w w w w w w w w w w w w w w w w w w w w w w w w w w w w w w w w w w w w w
w p p w w p p p p w p p w w p w w p p p p p p w w p p p p p w w p w w p w w p w w p p w w p w p w p w p p p p p p p p p p p p w p p w p p p p p p p p p p w p w p w w p w w w w p w w p w p p w w p w p w
w p p w w w w w p p p w w p p w w w w w w p w w w w w p w p p w p w w p w w p w p p w w w p p p p p w w w w w w w w w w w w p w w p p p w w p w w w w w w w p w p w w p p w w p p p p p w p w w w p w p w
w w p w p w w p p w w w w w p p w w w p p p p w w p w w w w p w p w w p p w p w w p p p w w w w w p w w p w w w p p p w p p p p p p w w w p p p w w w w p p p w p p w w p p w w p w w p w p w p w p w p w
w p p w p w p p w w p w w p p w w p w w w p w w p p p w w p p w p w w w p w p p w w p w w p p w w p w p p p p w w w p w w w p w p w w w w w w p p p p w w p w w p w w p p w w p p p w w w p p p w p w p w
w p w w p w w p w w p w w w p p w p w w p p p w w w p w w w p p p w p w p w p w w p p p w w p w p p w w w w p p p w p w p w p w w w w p w p w w p w w w p p p w p p w w p p w w w p p w p p w w w p w p w
w p p w p w w p p w p p p w w p w p p w w w p p w w p w p w w w p w p w p w p p w p w p p w p w w p w p p p p w p p p p p p p p w p p p w p w w w w p w w p w w p w w w p w w p w p w w p w w p w p p p w
w w p p p w w p w w p w w w w p w p w w p w p w w p p p p p w w p w p w p p p w w w w p w w p p p p w w w w w w p w p w p w w p w p w w w p w p w p p p w p w w p w p w p p p p p p p p p w p p p p w p w
w w w w p w p p p p p p w w p p w p w w p p p p w w p w w p w w p w p w w w p p w w p p p w p w w p p w w p w p p w w w w w w p w p p w w p p p w p w w w p p w p w p p p w w w w w w w w w p w p w w w w
w w w w p w p w w p w w w w w p w p w w w p w w w p p w p p w p p p p p w w p w w w p w w w w w w w p w p p w w w w w p w p w p w p w w w w w p w p w p w p w w p w w w p p p p p p p p p w p w w w w w w
w w p w p w w w w p p w w p p p p p p w w p p w w w w w w p w w w w w p w w p w w p p p w p w p p p p w w p w w w p w p p p p p w p p w w p w p w p p p p p p w p w p p p w w w p w w w w w p p w p w p w
w p p w p w w p w p w w w w w w w p w w w p w w p w w p w p w p p w w p w p p w w w p w w p w w w w p w w p w p w p w w w w w p w p w w p p w p w p w w w w w w p w p w p p p w w w p p p w w p w p p p w
w w p p p p p p p p w w w w p w w p w w p p w w p p w p w p w p w w p p p p w w p w p p p p w w p p p p p p p p w p w p w w p p p p p w w p p p p p p w p w w p p w w w p w w w w w w p w w p p w p w w w
w w w p w w w w w p p w w p p p w p p w w p p w w p w p p p p p w w w w w p w w p p p w w w w w w p w w w w w p p p p p w w p w w w p w p p w w w w w w p p w w p w w p p w p w p w p p p w w p p p p p w
w w w w w p p p p p w w w w w p w p w w p p w w p p w w w w w p p p w w w p p p p w p p p p p w w w w w p w w w w w w p w w w w w w p w p w w w w p p p p w w p p p w w p w p w p w p w w w w w p w w w w
w w p w w w w w w p w p p w w p p p p w p w w w w p w w w p p p w w w p w p w w w w w w w w w w p w p p p w p w p w p p p w w p p p p p p w w p w p w w w w w w p w w p p w p w p p p p p p w w p p p p w
w p p p p p p p p p p p w w w w p w p w p p w w p p w p w w w p p p p p p p p w p w w p p p w w p w w w p p p w p p p w w w w w w w p w w w w p w p w w p w w p p p w w p p p p p w w p w p w w p w w w w
w w p w w w p w p w w p p w p w w w p w p w w p p w w p w p w w w p w p w p w w p p w p w w w w p w p w w w p w w w p p p w w p p p p p w w p p p p w p p w w w p w w p p w w w w w w w w w w p p p w p w
w w w w w w w w w w w w p p p w w p p p p p w w p p w p w p p w w p w p w p p p p w w p w w p p p w p p w p p p p p p w w w w w w w p w w w w w w p p p w w p w p p w w p p p p p p p w p w p p w p p p w
w p w p p p w p p p p w p w w w w w w p w w w w w p w p w p w w w w w w w p w w w w w p p w w w p w w p w w p w p w p p w p w w p p p p w p w w p p w w w w p w p w w w p w w w w w w w p p p w w w w w w
w p p p w p w w w w p w p w w p w p w p w w p w w p w p p p p w p w p w p p p w p p w w p w p w p p w p p w w w w w p w w p w w w w p w w p w w p w w p p w p w p w w p p p w p w w p p p w w w w w w p w
w w w w w p p p p p p p p p p p p p p p p p p w p p w w p w p p p p p w w p w w p w w w p p p w w p w p w w w p w p p p w p w p w w p p p p w w p p p p w w p p p w w w p w w p w p p w p p p w w p w p w
w p w w w w w w p w w w p w p w p w w w w w p p p w w w w w p w p w p p w p w p p p p w w p w w p p w p w w p p w w p w w p p p p w w p w w w w p w w w w p p w w w p p p p w p w p w w w p w w p p p p w
w p p p w w w w w w p p p w w w p w p p p p p w p p w p p w w w w w w p p p w p w w w w w p p w w p w p w w w p w p p p w p w w w w p p w p w p p w p p w w p w p w w p w w w p w p w p w w w w p w w w w
w w p w w p p p w p p w p w w w w w w w w w w w w p w p w w w w p p w p w w w p p p w w p p w w p p w p w p w p w w w p w p p w w p p w w p p p w w p w w p p p p p p p p p p p p p p p p w w p p p w w w
w w p w w w w p w w w w p w p w w w w w p p p p w p p p w w p w w p w p p w w w w p p w w p w p p w w p w p p p w p p p w w p w p p w w w p w w w w p p p p w w w w w w w w w p w w w p w w w w w p w p w
w p p p w w p p p w w w w w p w p w p p p w w p p p w p p w p w p p w p w w p p w p w w p p p p w w w p w w w p w w w p w w p p p w w p w p w w p p p w w p p p w p p p p w w p p w w w w p w p w p p p w
w p w w w w w p w w p p w w p w p w w w w w w w w w w w p p p w w p w p p w w p w p w w w p w w w p w p w p p p p w p p p p p w p p p p w p p w w p w w w w w w w p w w w w w w w w p w w p w p p p w w w
w p p w w p p p p w w p w w p w p w w p w p w w p w p w w p w w p p p p w w p p w p w p w p p w p p w p w w w w p p p w w w w w p w w w w p w w p p w p p w p p p p p w w p w w w p p p w p w w w p w p w
w w p p w w w p w w p p w w p w p w p p p p p p p w p w p p p p p w w p w w w p p p w p w p w w p w w p w p p p p w w w p w w w p p w w p p w w w p w p w w p w w w w w p p p p w w p w w p w p w p p p w
w w w p w p w p w w w p w p p p p w w w w w w w p w p w w p w p w w p p p p p p w p w p p p p w p w w p w w w p w w w w p w p w p w w p p w w p w p p p p p p p p p p w w p w w w w p w p p p p p p w p w
w p p p p p p p p p w p w w p w w w w w p p p w p p p p w w w p p w w w w w w w w p w p w w w w p w w p w w w w w w p p p p p p p p w w p w p p p p w p w p w w w w p w w p w w p p p p p w w w w w w w w
w w w w w p w w w p w p w w p p w p p w w w p w p w w p w p p p w w p p p p p p p p w p w p w w p w w p w p w w p w w w w w w w w p w p p p p w w p w p w p p p p w p w p p p w w w p w w w w w p w w w w
w p p w w w w p p p p p w p p w w p w w p p p w p w w w w w p w w w w w w w w w w p w p w p p p p p w p w p w p p p p w w p w p w p p p w w w w p p w p w p w w w w w w w w p p w w p w w p p w p p w p w
w w p w p w w w w w w p w w p w w p w w w w p p p p w w p w p p p w w w p p p p p p p p p p w w w w w p w p w w w p w w w p w p w p w p p p p w w w w w w w w w w p w w p w p w w p p w w p w w p w w p w
w p p p p p p w w w p p p p p w w p w p w p p w w p p w p w w w w w p p p w p w w w w w w p p w p p w p w p p p w p w w p p p p p p w p w w w w p w w p p w p p w p w w p p p p w w p w w p p p p p w p w
w w p w p w p p p w w w w w p w p p w p w w w w w p w w p p w w p w w w w w w w p p p p p p w w p w w p w w w p p p w w w w p w w w w w w w w p p p w w p w p w w p p w w w w p p w p w w p w p w p p p w
w w w w w w w w p p p p p p p w w p w p w p w p w p w w p w w w p p p w w p w w w w w w w p p p p p w p w p w w w p w p w p p p p p p w p p p p w p p w p w p p w w p w p p w w p w p w w p w w w w w p w
w p w p w w p w p w w p w w p p p p p p p p p p w p w w p p p w w w p w w p w p p p p w w w w p w p p p p p w w p p p p w p w w w w w w p w w w w w p w p w p w w p p p p w w p p w p p w p w w w w w w w
w p p p p p p p p p w w w w w p w w p w w w w p p p p w p w w w w p p w p p w w w w p w p w w w w w w w w p w w w w w p p p w w w w p p p p p p w w p w p p p w w w p w p p p p w w p w w p p p w p w w w
w w w w w p w p w p w p p p p p w p p w w w p p w w p p p p w p w w p w p w w p p p p p p p p p p p p p p p w p w w w w w p p p p w p w w w w p p w p w p w w w p w w w w w p w w p p p p p w w w p w p w
w w w p p p w w w w w w w w w p w p w w p p p w w p p w w p p p w w p w p w w w w w w w w w w w w w w w w p p p p p w w p p w w p p p w w p w w w w w w p p p w p w w p w w p w w w p w w w w w w p w p w
w p w w w p p w w p p p p p p p w p w p p w p w p p w w p p w p p p p p p p w p w p w p w p p p p p w p w p w w p w w p p w w w p w w w w p p p p w w p p w w w p w w p w w p p p w p w w w p p w p p p w
w p p p p p w w w w w p w w w p w w w w p w w w w w w w w w w w w w w w w p w p w p p p w w w p w p p p p p p w p w w w p w p w w w w p p p w w w w w w p w w p p w w p w p p w w w p w p w w p w p w w w
w p w p w p p w w p p p w p p p w p p p p w w p w w p w p w p w w p w p w p w p w w w p p w w w w w p w w p w w w w p w p p p p w p w w w p p p p p w w p w w w p w p p w w p p p p p p p w p p p p p p w
w p w p w w w w p p w p w p w p w w p w p w p p p p p w p w p p p p p p w p w p w p w w p p w w p w w w p p p w w p p w w p w w w p p w p p w p w w w p p p w w p w w p p p p w p w p w w w p w w w w w w
w p w p p p p w w w w w w w w w w w w w w w w p w w p w p w w w w w w p w p p p w p w w p w w w p w w w w w p p w w p w w p w w p p w w p w w w w p w w p w w p p p w w w p w w p w p p p p p p p w p w w
w p w w w w w w p w p p p p p p p p p p p p w w w p p p p p p p p w w p p p w p p p w w p p p p p p p p p p p w w p p p p p w p p w w p p w p w w p p p p p w w p w w w p p w w p w p w p w w w p p p p w
w w w w w w p w p w w w p w p w w w p w w p p p w w w p w w w w p p p p w p w p w p p p p w p w w w w w w w p w w w w w w p p p w w w p w w p w w p w w w w w w p w w p p w w w p w p w p w w w w w w p w
w p p p p p p p p w w w w w w w w w w w w w p w w p w w w w w w w w w p w w w w w w p w w w w w w w p w p p p p w w p p p p w p p p w p w p p p w p p p w w p w p w w w p p p w w w w w p p p p w w w w w
w w w w w w w w p p p w w w p p p p p p p w p w p p w w p p p p p p p p p w w p p p p w p p p p p w p w w w p w w w w w w p w p w w w p w p w w w p w w w w p w p w p w p w w w w w w w w p w p p p p w w
w w p p p p w p p w w w p w w w w w w w p p p w w p p w w w w w w p w p w w w w w w w w w w w w p p p w p w p p w p w p w p w w w p w p w p p p p p p w w p p p p w p p p p p w p w p w w w w w p w p p w
w p p w w p w w p w p w p w p p w w p p p w p p p p w w p w w w p p w w w p w w w w w w w w p w w w p w p w w p w p w p w p p w w p p p p p w w w w w w w w p w p w p w w w p p p w p p p w p w w w w w w
w w p w p p p p p w p w p w w p w p p w w w w p w p p p p w p w w w w w w p w p p p p w p w p w p p p p p p p p p p p p p p w w w w w p w w w p p p p p w w w w p p p p w w w w p w p w w w p p w p w w w
w w w w w p w w p p p p p p w p w w w w w w w w w w p w p p p w p w w p w p w w w w p p p p p p p w p w w p w w w p w w w p p w w p p p w p w p w w w w w p w p p w w w w p w w w w p p p p p w w p p p w
w p p w w w w w w w w w w p p p p w p p p w p w p w w w w w p w p w p p p p w p p w w w w w p w w w w w w p w w w p w p p p w w w w w p p p p p w p p w p p w w p p p p p p p p w w p w p w w w p p w w w
w p w w p w p w w w w p w w w w p w w w p p p p p p w p p p p p p w w w w p w w p w p w w w w w w p w p w w w p w w w w w p p w w p p p w w w w w p w w p w w p p w w w p w w w w w p w w w p w w p w w w
w p w p p w p w p p p p p p p p p w p w w w w w w p p p w p w p w w w p p p p p p p p w p w w w p p p p p w p p w w p w w w p p w w p w w p p w w p w w p w p p w w p w w w p w w p p p w p p w w p p p w
w p w w p p p w w w w w w w p w p p p w w w w p p p w w w w w p w p w w w w w w w w p w p w p w w w w w p w w p w w p p p w p w w p p w p p w w w p p w p w p w w p p p w p p p w w p w w p w w w p w w w
w p p w w w p p p p p p p w p w w w p p p p p p w w w w p w p p p p p p p w w w p p p w p p p p p p w p p p p p p w w w p w p w w p w w p w w w p p w w p p p w p p w w w p w w w p p p w p w p w p p p w
w w p p p p p w w w w w p p p w w p p w w p w w w p p p p w w w w w w w p p p p p w p p p w w w w p w w w w w w p w w p p w p w w p w p p p p p p w w w w w p w p w w p w p w p p p w w w p w p p p w p w
w w w w p w p w p p p p p w w w w w p w w p p w w w w w p p w w p p p p p w p w p w w p w w w p p p p p p w p w p w w w p p p w p p p p w p w w w w w p w w p p p p p p w p w p w w w p p p p p w w w w w
w p p w w w w w w w p w p w w w p w w w w w w w p w w w w p p p p w w w p w p w w w w w w w p p w w p w p p p p p w p w w w p w p w w w w w w w w p w p w p p w w w w p p p p p p p w w w p w p p w p w w
w w p w p p p p w w w w w w p w p w p p p p p p p w p w w p w w p w p p p w p w w p p w p w w w w w w w w w w w p w p w p w p w p w p p p w w p w p w p w w p p p w w w w w w w w w w p w p w w p p p p w
w w p w w p w p p p w p p p p p p w w w w w w w p p p p p p w p p w w w w w w w w w p p p w w w w p w p w w w p p p p p p p p p p p p w p w w p p p p p w w p w w w p w w w p p p p w p w p p w w w w p w
w p p p w w w w w p w w w w w w p p w w w p p w p w p w p w w w w w p w w w w w w w w w p w p p p p p p p p p p w w p w w w p w w w w w w w w w w p w w w p p p p p p p p w w p w w w p w p w w w p w w w
w w w p p w w p p p w w p p p w w p w p w w p p p w p w p w p p p p p p p w p w w p w p p p p w p w p w p w w p w p p w p p p p p w w p w w w w p p p p w w p w w w w w p p w p p p p p p p p p p p p w w
w p w w p p w w w p p w w w p w w p w p w p p w p w w w w w w w w p w w p w p w p p p p w w w w w w w w w w w w w w w w w p w w w w w p p w w p p w w p p p p p w w p w w p p p w p w p w w w w w w p p w
w p p w p w w p w w p w p p p p p p p p p p w w p p w p w p w w w w w p p p p p p w w w w w w p w p w p w p w w p p p p p p p w w p w w p w w p w w w w w w w w w p p p w w w w w p w p p p p p p w w w w
w w p w p w w p p w p w w w w w w w w w w p p w w p w p p p w p p w p p w w w w w w w w w p p p p p p p w p p p p w p w w w p p w p p w p p p p p p w w w w w w p p w p p p p w w w w w w w w w w w w p w
w w p w p p w w p p p p w w w w w w p p p p w w w w w w w p w w p w w p w p p w p p p p p p w w w p w p p p w w p w w w w w p w w p w w p w p w w p p p p p p p p w w p w w p p p p w w w w w p w w p p w
w p p w w p p w w p w p p p p p p p p w p w w w p w p w p p p p p p p p w w p w w w w w w w w w w w w w p w w p p w w p p p p p p p p w p w w w w w w w w p w w w w w w w w w w p w w p p p p p p p p w w
w w p p p p w w w p w w w p w p w w p w w w p p p p p w w p w w w p w p w p p w p w w p p p p p p p p p p p w w p w w w w w p w p w p p p p w p w w w w w p w p p p w w p w w w w w p p w w w w w w w w w
w p p w w p w w p p p w w w w p w w w w w w w w w p w w p p w p p p w w w w p p p p p p w w w p w w w p w w w w w w p w p p p w p w w p w p p p p p p p w w w p w w w p p p p p p w w p p p p w w p w p w
w w p w w p p p p w p w p w p p w p p p p w w p p p p p p w w p w w w w p w p w p w w p w p w p w w p p w w p p p p p p p w p w p p w p w w p w p w w p p w p p p p p p w w w w w w p p w w w w w p p p w
w w w w p p w p w w w w p p p w w w w w p p w w p w p w w w w w w p p p p p p w w w w w w p p p w w w p w w p w w w w w w w p w w p w p p w p w p p w w p p p w w p w p p w p w p w p w w w w p w p w p w
w p p p p w w p p w w p p w p w p w w w w p p p p w w w w p w w w w w w w w p w w p p p p p w p w p p p w w p w p p p w p p p p w w w p w w w w w p p w w p w w w w w w w w p w p w p p p p p p p p w w w
w w w p w w w w p p w w p w w w p p p p p p w p w w w p p p p p w w w p p p p p w p w w p w w w w p w p p w w w w w p p p w w p p w w p p p w w p p w w p p p p p w p w w w p w p p p w w w p w p w w w w
w p p p p p w w w w w w w w p p p w w w w p w w w p w w w w w p w p w w w w w w w w w p p p w w w w w p w w w p w w w w p p w w p w w p w p p w p w w w w p w w p p p p p p p p p w w w w w w w p p p p w
w w p w w w w p w w p w w p p w p p w w w w w p p p p p w p p p w p w p w p w p w w p p w p w p p p p p w p p p p p p p p w w p p p w p w p w w p p w w p p p w p w p w w w p w p p p p p p p w w w w w w
w p p w p p p p p p p p p p w w w w w p w w w w w w w p p p w p p p p p p p p p p p p w w w w w p w p w w w w p w w w p w w w w p w w p w w w p p w w p p w p w p w p p w w p w p w w w w p w w w w p p w
w w w w w p w p w p w p w p w p p p p p p p p w p w p p w p w p w p w p w p w p w w p p w w w w w w w w p p p p w p p p w w p p p p w p p p w p w w w p w w p w p w p w w w p w p p p p w p p w p w p w w
w p p p p p w p w p w p w p w p w w w w p w p p p p p w w p w p w w w w w w w w w w p w w p w w p p w w w p w p w w p w w w w p w w w w p w w p p p w p p w w w p w p w w p p w w w p w w w p w p p p p w
w w w w p w w p w w w w w p w w w w w w w w w w w w p w w p w p w w p p p p p p p p p w w p w w w p p w w w w w w p p w p w p p w w p w w w w w w w w w w w w w p w p w w w p p p w p w w p p p p w w w w
w p p p p p w w w w p w w w w w p p p w w p p p p p p w w p w p p w w w p w p w p w p w p p p p w w p w p w p w p p w w p w w p p p p p p w p p p p p p p p p w w w p p w w p w w w p p w w p w p p p p w
w p w w p w w p p p p p w w p p p w p p p p w w p w p p w p w w p w p p p w w w p w w w w w w p p p p p p p p p p w w p p p p p w p w w p p p w w p w w p w p p w w p w w w p p w w w w w p p w p w p w w
w p w w p p w w p w w p p w w w p w w w w w w w w w p w w w w w w w w p w w p p p w w p p p w w w w w w w w p w p p w w w p w p w p w w p w p w w p p w w w w p p w p p p w w p p p p p w w p w p w w w w
w p w w w p w w p p w w p p p w w w w w w w p w p p p p w w p p w w w p w w p w w w w w w p p p p p p p p p p w p w w p p p w p w p w w p w p p w w p w w w p p w w p w p w p p w p w w w w p w p p p p w
w w w p p p p w p w w p p w p p p p p p p p p w w p w p p w w p p w p p w p p p w w p w w w p w w p w w p w p w w w w w w p w p w p p w p w w p p w w w p w p w w p p w w w w p w p w w p w w w p w w w w
w p p p w w p w w w p p w w w w p w p w w w p p w w w w w w w w p p p w w w p w w p p p w w w w p p w p p w p w w p p w w w w p w p w w p w p p w w w w p w w w w w p p w w p p w p p p p p w w w w w p w
w w w w w w w w w p p w w p p p p w p w w w w p p w p w p w p w w p w w p w w w w w w p p p p p p w w w p w p p p p w w p p p p w p p w p w w p p p p p p p p p p w w p p w w w w p w w w p p p p p p p w
w p w w p w w p w p w w w w w w w w w w p w w w p w p w p p p p p p p w p w w p w p w w w p w w p w p p p w p w p w w w w w w p w w w w p w p p w p w p w w w w w w w w w w p p p p p p w p w p w p w p w
w p w w p w p p w p w p p p p w w p w p p p p p p p p p p w w w w w w w p w p p p p p p p p w w w w w p w w w w p w w p p p p p w w w w w w w p w p w p p p w p w w p w w w w w p w p w w p w p w p w w w
w p w p p p p w w w w w w w p p p p w w w w w w w w w w w w w w w w w w p w w p w p w p w p p w w p p p p w w p p p w w w p w p p p p w w p p p w p w p w w w p w p p p p p w w w w p w w w w p w w w w w
w p p p w w p p w w p w w w w p w p p p p w w p p p p p p p p p p p p p p p p p w p w p w w p p w w w p w w p p w p w w p p w p w p w w p p w p w w w p p p p p p p w w w p p p w w p p w w p p p w w p w
w p w p p w w p p p p p p p w w w w w w p p w p w w w p w w p w p w w w w w w p w p w p w p p w w p p p p w w p w p p w w w w p w w w w w p w p p p w w p w p w w w w w w w w w w p p w w w w w p p p p w
w p w w p w w w w w w w w p w w p w p w w p p p w w p p w w p w p p w w p p p p w w w p w w w w w w w p w w p p w w p p w w w p p p p p w p w p w w w p p w p p p p p p p w w w w w w w w p p p p w p w w
w p w w p w p w w w w p w p w p p p p p w w p w w w w p w p p w w w w p p w w p w w p p w w p p p p p p p w w p w w p w w p p p w p w w w w w p p w w w p w p w p w w w w w p p w p p p w w w p w w p w w
w p w w w w p p p p p p p p p p w w w p p p p w p p p p w w p w w w w w p w p p p w w p p w w p w w w p w w p p p w p w w w p w w w w w p w w w p w p w p w p w p p p p p w p w w p w w w w p p p w p p w
w p p w w p p w p w p w p w w p p p w w p w p w w p w p w p p w p p p p p w p w p w p p w w p p w p p p p w p w p w p w p p p p w w p p p p p p p p p w p w p w w p w w p p p p p p p p p w w p w w p p w
w w w w w w w w w w w w w w w w w w w w w w w w w w w w w w w w w w w w w w w w w w w w w w w w w w w w w w w w w w w w w w w w w w w w w w w w w w w w w w w w w w w w w w w w w w w w w w w w w w w w w
